一心	intended
一手	all on your own
一片	a slice
一致	unanimous, Consistent
不相上下	Neck and neck 不相伯仲
掉下來	fall down
不及	Less than
不平	Uneven
不幸	unfortunately
不盡	Endless
不顧	In spite of
中間	Intermediate
主張	Advocate
主觀	Subjective
事務	business
事業	career
交代	Explain
交易	Transaction
人家	other people, folk
仇恨	hatred
代價	Cost
代理	agent
低下	Low
低頭	Bow
佔領	Occupation
作為	As
作用	Effect
作風	Style
來源	Source
例外	exception
依照	according to
依靠	rely on
保證	Guarantee
保障	Protection, guarantee
修理	repair
值得	worth it
傳達	convey
傾倒	Dumping, pour
價值	value
充實	Full
先後	Successively
先進	advanced
光亮	bright
光彩	Brilliance
入口	Entrance
全部	All, whole
共用	Shared
冰冷	Cold, Icy
冰雪	Snow and ice
冷落	Left out
出來	come out
出動	Dispatch
出外	Go out
出賣	Sell
出路	Way out
出身	Origin
出門	Go out
分開	separate
判斷	judgment, Judge
制度	system
前夕	eve
前提	premise
前鋒	forward, Striker
剛好	just
創作	creation
劃分	Divided
力量	power
加入	Join
加工	Processing, machining
加油	Come on
動手	DIY
勸告	advice
千萬	Thousands, Million
協定	agreement
協調	coordination
協議	protocol
原來	original
原始	original
參加	participate
口氣	Tone
只是	just
可是	but, however
吃虧	Loss, Suffer
名字	name
名義	name
告訴	tell
命令	command	command
命運	fate	Fate
和氣	And gas	And
品種	Variety	Varieties
啟示	Inspiration	Enlightenment
嚴格	strict	Strictly
嚴肅	serious	Serious
嚴重	serious	Serious
因果	cause and effect	Causal
因素	factor	Factor
困難	difficult	Difficult
固定	fixed	fixed
圍繞	around	Around
土地	land	land
堅定	firm	Firm
堅強	strong	Strong
壯觀	Spectacular	Spectacular
夢想	dream	Dream
大小	size	Size
大意	main idea	Careless
失敗	failure	Failure
奇怪	strange	strange
好看	good looking	Good-looking
始終	Always	Always
委屈	Wronged	Grievance
安心	Peace of mind	Peace of mind
安慰	comfort	comfort
完全	complete	completely
寄託	Sustenance	Sustenance
實用	practical	Practical
實踐	practice	Practice
實際	actual	The actual
寶貝	baby	Baby
專業	profession	Professional
尊嚴	dignity	Dignity
尊重	respect	respect
對面	opposite	Opposite
山野	Mountain	Wild
工作	jobs	work
工程	engineering	engineering
干涉	put one's oar in	interference
平和	Peaceful	Peaceful
平穩	smooth	Smooth
幸福	happy	happiness
幼稚	naive	Immature
建築	building	Building
弊病	Ills	Ills
引用	Quote	Quote
引誘	Lure	seduce
強壯	strong	Hale
形象	Image	image
後人	Descendants	Later
復興	revival	Renaissance
心思	thought	Thoughts
快樂	happy	Happy
急躁	impatient	Impatient
恐怕	I am afraid	I'm afraid
悲劇	tragedy	Tragedy
想像	imagine	imagine
意外	accident	Accident
意義	significance	Meaning
意見	opinion	Opinions
感動	Moving	Moved
感染	infection	Infected
感覺	feel	Feeling
應付	Handle	Payable
應對	response	To deal with
應徵	Application	Apply
懷抱	embrace	Embrace
成功	success	Success
成就	achievement	achievement
成熟	mature	mature
手工	manual	manual
手脚	Hands and feet	Hands and feet
打扮	dress up	dress up
打算	intend	Plan
批判	criticism	critique
技術	technology	Technology
投入	Put in	Investment
投機	Speculation	Speculation
投資	investment	Investment
招致	lead to	Lead
挫折	frustration	frustration
挫敗	defeat	thwart
採購	purchase	Purchasing
提升	Enhance	Promote
提議	proposal	Proposal
提起	Lift up	Mention
搭配	With	collocation
收縮	shrink	Contraction
效果	effect	Effect
效率	effectiveness	efficiency
教授	professor	professor
教育	education	education
文化	culture	Culture
文明	civilization	civilization
新鮮	fresh	Fresh
方便	Convenience	convenient
明天	tomorrow	Tomorrow
明白	understand	clear
是非	Right and wrong	Non
時光	Time	Time
時刻	time	Moment
普及	universal	Universal
有關	related	About
有限	limited	finite
根據	according to	According to the
極端	extreme	Extreme
概括	Summarized	Generalization
模糊	blurry	vague
檢查	an examination	Check
欠缺	Lacking	Lack
歡喜	joy	Joy
歡迎	welcome	Welcome
正當	Just right	Right
步伐	pace	pace
武力	force	force
武器	arms	arms
歷史	history	History
比喻	metaphor	analogy
氣味	odor	Smell
氣質	temperament	Temperament
氣魄	Spiritual	verve
水平	Level	level
永遠	forever and always	Forever
汗水	Sweat	sweat
沉寂	Silence	Quiet
沉重	heavy	heavy
沉默	silence	silent
泡沫	foam	foam
消化	digestion	Digestion
消磨	Kill	To spend
消耗	Consumption	consume
深厚	deep	deep
深度	depth	depth
清楚	clear	clear
清脆	Crisp	Crisp
渺茫	Slim	Slim
準備	ready	Ready
滋味	taste	Taste
滋潤	Moisturizing	Moisturizer
潛能	Potential	Potential
灰色	gray	gray
無情	ruthless	Ruthless
無聊	bored	Boring
照耀	Shine	Shine
營造	Create	Create
爭取	Fight for	For
狹隘	narrow	Narrow
玩弄	play	Play
生氣	pissed off	Angry
異同	Similarities and differences	The similarities and differences
當中	among	Among the
當然	of course	Of course
相反	in contrast	Contrary
相識	acquaintance	Acquaintance
矛盾	contradiction	contradiction
破爛	tattered	Junk
破碎	broken	Fracture
破裂	rupture	fracture
確切	exact	Exact
確定	determine	Sure
祝福	blessing	blessing
神氣	air	Air
移植	transplant	transplant
稱呼	call	Title
突出	prominent	prominent
笑話	joke	Joke
管教	Discipline	Discipline
精彩	wonderful	Marvellous
純粹	purely	Pure
紛紛	In succession	Have
細緻	meticulous	Detailed
組合	combination	Combination
結果	result	Results
結論	in conclusion	Conclusion
統治	rule	Rule
經驗	experience	Experience
綜合	Synthesis	Comprehensive
維持	maintain	Maintain
縱橫	Vertical and horizontal	Aspect
總結	to sum up	Summary
繁榮	prosperity	Prosperity
繼承	inherit	Inheritance
習慣	habit	Habit
老實	honest	Honest
老虎	tiger	Tiger
聞名	famous	Famous
胃口	appetite	Appetite
能夠	were able	Can
脾氣	temper	temper
腐化	corrupt	Corruption
腐敗	corruption	Corruption
腐爛	rot	Decay
腦筋	Brains	Head
腳步	pace	Footsteps
臉色	Face	Face
自動	automatic	Automatic
自覺	conscious	Consciously
舒服	Comfortable	comfortable
萌芽	bud	Germination
萬千	Thousands	Thousands of
著作	book	Work
藝術	art	Art
處分	Disposition	Disposition
衝動	impulse	Impulse
表現	which performed	Performance
表示	Said	Express
裁判	referee	Referee
補充	supplement	Supplement
裝置	Device	Device
裝飾	decoration	Decoration
要不	or	Or
覆蓋	cover	Cover
見識	experience	See
覺得	feel	Think
計較	Care about	Regardless of
訓練	training	Training
記錄	recording	Record
訪問	access	Visit
評價	Evaluation	Evaluation
評審	Review	Review
認同	Agree	Identity
語言	Language	Language
誤會	misunderstanding	Misunderstanding
誤解	misunderstanding	Misunderstanding
談話	conversation	Talk
講話	Speaking	Speech
證明	prove	Proof
議論	talk	Talk
護理	Nursing	Nursing
豐富	rich	Rich
豐滿	full	plump
象徵	Symbol	Symbol
負擔	burden	The burden
負責	Be responsible for	Responsible for
貪心	greedy	Greedy
資料	data	Data
資格	qualifications	Qualification
趨向	tend	Trend
距離	distance	Distance
路上	On the road	On the road
路程	Distance	distance
身份	Identity	identity
輕便	light	portable
輕巧	Lightweight	Light
轉化	Conversion	Conversion
轉折	Turning point	Turning
轉移	Transfer	Transfer
迷惑	confuse	Confuse
通知	Notice	notice
通過	by	Through
進去	Go in	In
進口	import	Import
進步	progress	Progress
遊行	procession	The parade
道路	the way	Road
適中	Moderate	medium
遮擋	Blocked	Occlusion
配角	supporting role	Supporting rule
野蠻	brutal	Savage
錯誤	error	Error
鍛鍊	work out	Exercise
鎮定	Calm	Calm
阻塞	block	block
阻礙	Hinder	Block
附屬	Subordinate	Affiliated
附近	nearby	nearby
陣容	line-up	Lineup
陰謀	conspiracy	Conspiracy
隱蔽	hidden	Hidden
難受	Uncomfortable	Uncomfortable
難得	rare	Rare
難過	Sad	Sorry
靠近	near	near
須知	Notes, Notice
預料	Expected
頒發	Issued
願意	Willing to
驅動	drive
高潮	climax
高等	higher
高貴	noble
鮮明	Clear, Bright
鼓動	Agitate
鼓舞	Inspire
